0 0 0 0 0 0 0 0 0 0 0 0 0 0 0 0 0 0
0 0 0 0 0 0 0 0 0 0 0 0 0 0 0 0 0 0
0 0 2 5 3 4 2 4 4 3 2 4 3 4 5 5 0 0
0 0 5 1 4 2 3 3 5 1 4 1 1 4 4 3 0 0
0 0 2 4 4 1 2 4 4 3 2 3 5 3 2 5 0 0
0 0 1 1 5 4 1 3 3 2 4 1 1 2 2 3 0 0
0 0 5 2 5 2 4 2 5 4 2 5 4 5 4 1 0 0
0 0 2 4 3 4 4 3 2 1 3 1 1 4 4 1 0 0
0 0 5 5 1 3 2 2 4 5 4 1 1 2 5 5 0 0
0 0 5 1 5 1 4 1 2 4 1 5 4 1 5 2 0 0
0 0 0 0 0 0 0 0 0 0 0 0 0 0 0 0 0 0
0 0 0 0 0 0 0 0 0 0 0 0 0 0 0 0 0 0