0 0 0 0 0 0 0 0 0 0 0 0 0 0 0 0 0 0
0 0 0 0 0 0 0 0 0 0 0 0 0 0 0 0 0 0
0 0 2 7 3 6 2 4 4 3 2 4 3 6 7 5 0 0
0 0 7 1 4 2 3 3 5 1 6 2 1 6 6 7 0 0
0 0 2 6 6 1 2 6 4 3 2 7 5 3 2 5 0 0
0 0 6 1 7 4 1 3 3 2 6 4 1 2 2 3 0 0
0 0 5 5 7 2 6 2 5 4 2 7 6 5 4 1 0 0
0 0 6 4 3 4 4 3 5 1 3 1 3 4 6 1 0 0
0 0 5 4 1 3 2 2 6 5 6 3 1 2 5 7 0 0
0 0 6 1 5 1 4 1 2 6 1 7 4 1 7 2 0 0
0 0 0 0 0 0 0 0 0 0 0 0 0 0 0 0 0 0
0 0 0 0 0 0 0 0 0 0 0 0 0 0 0 0 0 0