0 0 0 0 0 0 0 0 0 0 0 0 0 0 0 0 0 0
0 0 0 0 0 0 0 0 0 0 0 0 0 0 0 0 0 0
0 0 6 5 3 5 2 1 4 3 2 3 3 6 3 5 0 0
0 0 7 1 4 2 3 3 5 1 6 7 1 6 6 7 0 0
0 0 2 6 6 4 2 6 5 3 2 3 5 3 2 5 0 0
0 0 6 1 7 4 1 5 3 2 7 4 1 2 2 3 0 0
0 0 5 2 7 2 6 2 5 4 2 2 6 5 4 7 0 0
0 0 6 4 3 2 4 3 5 1 3 5 1 4 6 1 0 0
0 0 5 5 1 4 2 2 6 5 4 1 6 6 5 7 0 0
0 0 1 1 5 1 4 1 7 6 3 7 4 1 7 5 0 0
0 0 0 0 0 0 0 0 0 0 0 0 0 0 0 0 0 0
0 0 0 0 0 0 0 0 0 0 0 0 0 0 0 0 0 0